1111111111111111111111
1000100000100010000001
1000000000100010000001
1000000000100000000001
1000000000000000001001
1000000000000000001001
1000000000000000001001
1000000000000000000001
1000000010000000001111
1000000010000000000001
1111111111111111111111